81 21 21 21 21 21 21 21 21 21 21 21 21 21 21 21 21 21 21 21 21 21 21 21 21 21 21 21 21 21 21 21 21 21 21 21 21 21 21 21 21 21 21 21 21 21 21 21 21 80
23 15 15 15 15 15 15 15 15 15 15 15 15 15 15 15 15 15 15 15 15 15 15 15 15 15 15 15 15 15 15 15 15 15 15 15 15 15 15 15 15 15 15 15 15 15 15 15 15 24
23 15 50 50 50 50 50 15 15 15 15 15 15 15 15 15 15 15 15 15 15 15 15 15 15 15 15 15 15 15 15 15 15 15 15 15 15 15 15 15 01 01 01 15 15 15 15 15 15 24
23 15 50 51 51 51 50 15 15 15 15 15 15 15 15 15 15 15 15 15 15 15 15 15 15 15 15 15 15 15 15 15 15 15 15 15 15 15 01 01 01 12 01 01 01 15 15 15 15 24
23 15 50 51 51 51 50 15 15 15 01 01 01 01 01 01 01 01 01 01 01 01 01 01 01 15 15 15 15 15 15 15 15 15 15 15 01 01 01 01 01 01 01 01 01 15 15 15 15 24
23 15 50 51 51 51 50 15 15 15 01 15 15 15 15 15 15 15 15 15 15 15 15 15 01 15 15 15 15 15 15 15 15 15 01 01 01 01 01 01 25 22 28 01 01 01 15 15 15 24
23 15 50 51 51 51 50 15 15 15 01 15 15 15 15 15 15 15 15 15 15 15 15 15 01 15 15 15 15 15 15 15 15 01 01 01 01 01 01 01 26 21 27 01 01 01 15 15 15 24
23 15 50 50 54 50 50 15 15 15 01 15 15 15 15 15 15 15 15 15 15 15 01 01 01 01 01 01 01 01 01 01 15 01 01 01 01 01 01 01 01 01 01 01 01 01 15 15 15 24
23 15 15 01 03 01 15 15 15 15 01 15 15 15 15 15 15 15 15 15 15 15 01 03 03 03 03 03 03 03 03 03 01 01 01 01 01 01 01 01 01 01 01 01 01 01 15 15 15 24
23 15 15 01 03 01 15 15 15 01 01 01 15 15 15 15 15 15 15 15 15 15 01 03 01 01 01 01 01 01 01 01 15 01 01 01 01 01 01 01 01 01 01 10 01 15 15 15 15 24
23 15 15 01 03 01 15 15 01 01 01 01 01 15 15 15 15 15 15 15 15 15 01 03 01 15 15 15 15 15 15 15 15 01 01 01 01 12 01 01 01 01 01 01 01 15 15 15 15 24
23 15 15 01 03 01 01 01 01 10 01 01 01 15 15 15 15 15 15 15 15 15 01 03 01 15 15 15 15 15 15 15 15 15 01 01 01 01 01 01 01 01 01 01 15 15 15 15 15 24
23 15 15 01 03 01 15 15 01 01 01 01 01 15 15 15 15 15 15 15 15 15 01 03 01 15 15 15 15 15 15 15 15 15 15 15 01 01 01 01 01 01 01 15 15 15 15 15 15 24
23 15 15 01 03 01 15 15 15 01 01 01 15 15 15 01 01 01 01 01 01 01 01 03 01 01 01 01 01 01 01 01 15 15 15 15 15 15 01 01 01 15 01 15 15 15 15 15 15 24
23 15 15 01 03 01 15 15 15 15 01 15 15 15 15 01 58 58 58 58 58 58 97 55 93 97 93 58 58 58 58 01 15 15 15 15 15 15 15 15 15 15 01 15 15 15 15 15 15 24
23 15 15 01 03 01 15 15 15 15 01 15 15 15 15 01 58 57 74 57 75 58 51 55 51 51 51 58 57 57 58 01 15 15 15 15 15 15 15 15 15 15 01 15 15 15 15 15 15 24
82 22 22 22 56 22 22 28 15 15 01 15 15 15 15 01 58 57 57 57 57 58 51 55 51 51 51 57 57 77 58 01 15 15 15 15 15 15 15 15 01 01 01 15 15 15 15 15 15 24
81 21 21 21 56 21 80 23 15 15 01 15 15 15 15 01 58 78 77 57 57 58 51 55 51 51 51 58 57 57 58 01 15 15 15 15 15 15 15 15 01 15 15 15 15 15 15 15 15 24
23 15 15 01 03 01 24 23 15 15 01 15 15 15 15 01 58 57 57 57 57 58 51 55 51 51 51 58 58 58 58 01 15 15 15 15 15 15 15 15 01 15 15 15 15 15 15 15 15 24
23 15 15 01 03 01 24 23 15 15 01 15 15 15 15 01 58 57 57 57 57 58 51 55 51 51 51 51 51 51 94 01 15 15 15 15 15 15 15 15 01 15 15 15 15 15 15 15 15 24
23 15 15 01 03 01 24 23 01 01 01 01 01 01 01 01 58 58 57 57 58 58 55 55 55 51 51 51 51 51 90 01 01 01 01 01 01 01 01 01 01 01 01 01 01 01 01 15 15 24
23 15 15 01 03 03 56 56 03 03 03 03 03 03 03 03 55 55 55 55 55 55 55 01 55 55 55 55 55 55 55 03 03 03 03 03 03 03 03 03 03 03 03 03 03 03 01 15 15 24
23 15 15 01 01 01 24 23 01 01 01 01 01 01 01 01 92 51 51 51 51 51 55 55 55 51 51 51 51 51 90 01 01 01 01 01 01 01 01 01 01 01 01 01 01 03 01 15 15 24
23 15 15 15 15 15 24 23 15 15 15 15 01 15 15 01 96 51 51 51 51 51 51 55 51 51 51 51 51 51 94 01 15 15 15 01 15 15 15 15 15 15 15 15 01 03 01 15 15 24
23 15 15 15 15 15 24 23 15 15 15 15 01 15 15 01 58 58 58 58 51 51 51 55 51 51 51 51 51 51 90 01 15 15 15 01 15 15 15 15 15 15 15 15 01 03 01 15 15 24
23 15 15 15 15 15 24 23 15 15 15 15 01 15 15 01 58 57 57 58 51 51 51 55 51 51 51 51 51 51 94 01 15 15 15 01 15 15 15 15 15 15 15 15 01 03 01 15 15 24
23 15 15 15 15 15 24 23 15 15 15 15 01 15 15 01 58 57 57 57 51 51 51 55 51 51 51 51 51 51 90 01 15 15 15 01 15 15 15 15 15 01 01 01 01 03 01 15 15 24
23 15 15 15 15 15 24 23 15 15 15 15 01 15 15 01 58 76 57 58 51 51 51 55 51 51 51 51 51 51 94 01 15 15 15 01 01 01 01 01 01 01 01 03 03 03 01 15 15 24
23 15 15 15 15 15 24 23 15 15 15 15 01 15 15 01 58 58 58 58 91 95 91 55 91 95 91 95 91 95 90 01 15 15 15 01 15 15 15 01 01 01 01 01 01 01 01 15 15 24
23 15 15 15 15 15 24 23 15 15 15 15 01 15 15 01 01 01 01 01 01 01 01 03 01 01 01 01 01 01 01 01 15 15 15 01 15 15 15 01 01 01 01 01 15 15 15 15 15 24
23 15 15 15 15 15 24 23 15 15 15 15 01 15 15 15 15 15 15 15 15 15 01 03 01 15 15 15 15 15 15 15 15 15 15 01 15 15 01 01 01 12 01 01 15 15 15 15 15 24
23 15 15 15 15 15 24 23 15 15 15 15 01 15 15 15 15 15 15 15 15 15 01 03 01 15 15 15 15 15 15 15 15 01 01 01 15 15 01 10 01 01 01 01 15 15 15 15 15 24
23 15 01 01 15 15 24 23 15 15 15 15 01 01 01 15 15 15 15 15 15 15 01 03 01 15 15 15 15 15 15 15 15 01 15 15 15 01 01 01 01 01 01 01 15 15 15 15 15 24
23 15 01 01 12 15 24 23 15 15 15 15 15 15 01 01 01 01 01 01 15 15 01 03 01 15 15 15 15 15 15 15 15 01 15 15 15 01 01 01 01 01 01 01 15 15 15 15 15 24
23 15 01 01 25 22 83 82 22 15 15 15 15 15 15 15 01 15 15 01 01 01 01 03 01 15 15 15 15 15 15 15 15 01 15 67 60 60 60 60 54 60 60 60 60 66 15 15 15 24
23 15 01 01 24 20 20 20 20 20 20 15 15 15 15 15 01 15 15 15 15 15 01 03 01 15 15 15 15 15 15 01 01 01 15 61 08 72 08 08 08 08 08 08 08 63 15 15 15 24
23 15 01 01 24 20 20 20 20 20 20 20 15 15 15 15 01 15 15 15 15 15 01 03 01 15 15 15 15 15 15 01 15 15 15 61 08 08 08 08 08 08 70 08 08 63 15 15 15 24
23 15 01 01 24 20 20 20 20 20 20 20 20 15 15 15 01 15 15 15 15 15 01 03 01 15 15 15 15 15 15 01 15 15 15 61 08 08 70 08 08 08 08 08 08 63 15 15 15 24
23 15 01 01 24 81 21 21 80 20 20 20 20 23 15 15 01 15 15 15 15 15 01 03 01 15 15 15 15 15 15 01 15 15 15 61 08 08 08 08 08 70 08 08 08 63 15 15 15 24
23 15 01 01 24 23 01 01 24 20 20 20 20 23 15 15 01 15 15 15 15 15 01 03 01 01 01 01 01 01 01 01 15 15 15 61 08 08 08 72 08 08 08 71 08 63 15 15 15 24
23 15 03 03 56 56 01 01 24 20 20 20 20 23 15 15 01 15 15 15 15 15 01 03 01 15 15 15 15 01 15 15 15 15 15 61 08 08 08 08 08 08 08 08 08 63 15 15 15 24
23 15 54 60 24 82 22 22 83 20 20 20 20 23 15 15 01 01 01 15 15 15 01 03 01 15 15 15 15 01 15 15 15 15 15 61 08 08 08 73 08 72 08 08 08 63 15 15 15 24
23 15 03 01 24 20 20 20 20 20 20 20 20 23 15 15 15 15 01 15 15 15 01 03 01 15 15 15 01 01 01 15 15 15 15 61 08 71 08 08 08 08 08 08 08 63 15 15 15 24
23 15 03 01 24 20 20 20 20 20 20 20 20 23 15 15 15 15 01 15 15 15 01 03 01 15 15 01 01 01 10 01 15 15 15 61 08 08 08 08 08 08 08 08 08 63 15 15 15 24
23 15 03 01 26 21 21 21 21 21 21 21 21 27 15 15 15 15 01 15 15 15 01 03 01 15 15 01 01 01 01 01 15 15 15 64 62 62 62 62 62 62 62 62 62 65 15 15 15 24
23 15 03 01 01 01 01 01 01 01 01 01 01 01 01 01 01 01 01 01 01 01 01 03 01 15 15 15 12 01 01 15 15 15 15 15 15 15 15 15 15 15 15 15 15 15 15 15 15 24
23 15 03 03 03 03 03 03 03 03 03 03 03 03 03 03 03 03 03 03 03 03 03 03 01 15 15 15 15 01 15 15 15 15 15 15 15 15 15 15 15 15 15 15 15 15 15 15 15 24
23 15 01 01 01 01 01 01 01 01 01 01 01 01 01 01 01 01 01 01 01 01 01 01 01 15 15 15 15 15 15 15 15 15 15 15 15 15 15 15 15 15 15 15 15 15 15 15 15 24
23 15 15 15 15 15 15 15 15 15 15 15 15 15 15 15 15 15 15 15 15 15 15 15 15 15 15 15 15 15 15 15 15 15 15 15 15 15 15 15 15 15 15 15 15 15 15 15 15 24
82 22 22 22 22 22 22 22 22 22 22 22 22 22 22 22 22 22 22 22 22 22 22 22 22 22 22 22 22 22 22 22 22 22 22 22 22 22 22 22 22 22 22 22 22 22 22 22 22 83