81 21 21 21 21 21 21 21 21 21 21 21 21 21 21 21 21 21 21 21 21 21 21 21 21 21 21 21 21 21 21 21 21 21 21 21 21 21 21 21 21 21 21 21 21 21 21 21 21 80
23 15 15 15 15 15 15 15 15 15 15 15 15 15 15 15 15 15 15 15 15 15 15 15 15 15 15 15 15 15 15 15 15 15 15 15 15 15 15 15 15 15 15 15 15 15 15 15 15 24
23 15 50 50 50 50 50 15 15 15 15 15 15 15 15 15 15 15 15 15 15 15 15 15 15 15 15 15 15 15 15 15 15 15 15 15 15 15 15 15 01 01 01 15 15 15 15 15 15 24
23 15 50 51 51 51 50 15 15 15 15 15 15 15 15 15 15 15 15 15 15 15 15 15 15 15 15 15 15 15 15 15 15 15 15 15 15 15 01 01 01 01 01 01 01 15 15 15 15 24
23 15 50 51 51 51 50 15 15 15 01 01 01 01 01 01 01 01 01 01 01 01 01 01 01 15 15 15 15 15 15 15 15 15 15 15 01 01 01 01 01 01 01 01 01 15 15 15 15 24
23 15 50 51 51 51 50 15 15 15 01 15 15 15 15 15 15 15 15 15 15 15 15 15 01 15 15 15 15 15 15 15 15 15 01 01 01 01 01 01 25 22 28 01 01 01 15 15 15 24
23 15 50 51 51 51 50 15 15 15 01 15 15 15 15 15 15 15 15 15 15 15 15 15 01 15 15 15 15 15 15 15 15 01 01 01 01 01 01 01 26 21 27 01 01 01 15 15 15 24
23 15 50 50 51 50 50 15 15 15 01 15 15 15 15 15 15 15 15 15 15 15 01 01 01 01 01 01 01 01 01 01 01 01 01 01 01 01 01 01 01 01 01 01 01 01 15 15 15 24
23 15 15 01 03 01 15 15 15 15 01 15 15 15 15 15 15 15 15 15 15 15 01 03 03 03 03 03 03 03 03 03 01 01 01 01 01 01 01 01 01 01 01 01 01 01 15 15 15 24
23 15 15 01 03 01 15 15 15 01 01 01 15 15 15 15 15 15 15 15 15 15 01 03 01 01 01 01 01 01 01 01 01 01 01 01 01 01 01 01 01 01 01 01 01 15 15 15 15 24
23 15 15 01 03 01 15 15 01 01 01 01 01 15 15 15 15 15 15 15 15 15 01 03 01 15 15 15 15 15 15 15 15 01 01 01 01 01 01 01 01 01 01 01 01 15 15 15 15 24
23 15 15 01 03 01 01 01 01 01 01 01 01 15 15 15 15 15 15 15 15 15 01 03 01 15 15 15 15 15 15 15 15 15 01 01 01 01 01 01 01 01 01 01 15 15 15 15 15 24
23 15 15 01 03 01 15 15 01 01 01 01 01 15 15 15 15 15 15 15 15 15 01 03 01 15 15 15 15 15 15 15 15 15 15 15 01 01 01 01 01 01 01 15 15 15 15 15 15 24
23 15 15 01 03 01 15 15 15 01 01 01 15 15 15 01 01 01 01 01 01 01 01 03 01 01 01 01 01 01 01 01 15 15 15 15 15 15 01 01 01 15 01 15 15 15 15 15 15 24
23 15 15 01 03 01 15 15 15 15 01 15 15 15 15 01 50 50 50 50 50 50 50 51 51 51 51 50 50 50 50 01 15 15 15 15 15 15 15 15 15 15 01 15 15 15 15 15 15 24
23 15 15 01 03 01 15 15 15 15 01 15 15 15 15 01 50 51 51 51 51 51 50 51 51 51 51 51 51 51 50 01 15 15 15 15 15 15 15 15 15 15 01 15 15 15 15 15 15 24
82 22 22 22 03 22 22 28 15 15 01 15 15 15 15 01 50 51 51 51 51 51 50 51 51 51 51 51 51 51 50 01 15 15 15 15 15 15 15 15 01 01 01 15 15 15 15 15 15 24
81 21 21 21 03 21 80 23 15 15 01 15 15 15 15 01 50 51 51 51 51 51 50 51 51 51 51 51 51 51 50 01 15 15 15 15 15 15 15 15 01 15 15 15 15 15 15 15 15 24
23 15 15 01 03 01 24 23 15 15 01 15 15 15 15 01 50 51 51 51 51 51 50 51 51 51 51 50 50 50 50 01 15 15 15 15 15 15 15 15 01 15 15 15 15 15 15 15 15 24
23 15 15 01 03 01 24 23 15 15 01 15 15 15 15 01 50 51 51 51 51 51 50 51 51 51 51 51 51 51 51 01 15 15 15 15 15 15 15 15 01 15 15 15 15 15 15 15 15 24
23 15 15 01 03 01 24 23 01 01 01 01 01 01 01 01 50 50 51 51 51 50 50 51 51 51 51 51 51 51 51 01 01 01 01 01 01 01 01 01 01 01 01 01 01 01 01 15 15 24
23 15 15 01 03 03 03 03 03 03 03 03 03 03 03 03 51 51 51 51 51 51 51 51 51 51 51 51 51 51 51 03 03 03 03 03 03 03 03 03 03 03 03 03 03 03 01 15 15 24
23 15 15 01 01 01 24 23 01 01 01 01 01 01 01 01 51 51 51 51 51 51 51 51 51 51 51 51 51 51 51 01 01 01 01 01 01 01 01 01 01 01 01 01 01 03 01 15 15 24
23 15 15 15 15 15 24 23 15 15 15 15 01 15 15 01 51 51 51 51 51 51 51 51 51 51 51 51 51 51 51 01 15 15 15 01 15 15 15 15 15 15 15 15 01 03 01 15 15 24
23 15 15 15 15 15 24 23 15 15 15 15 01 15 15 01 50 50 50 50 51 51 51 51 51 51 51 51 51 51 51 01 15 15 15 01 15 15 15 15 15 15 15 15 01 03 01 15 15 24
23 15 15 15 15 15 24 23 15 15 15 15 01 15 15 01 50 51 51 51 51 51 51 51 51 51 51 51 51 51 51 01 15 15 15 01 15 15 15 15 15 15 15 15 01 03 01 15 15 24
23 15 15 15 15 15 24 23 15 15 15 15 01 15 15 01 50 51 51 51 51 51 51 51 51 51 51 51 51 51 51 01 15 15 15 01 15 15 15 15 15 01 01 01 01 03 01 15 15 24
23 15 15 15 15 15 24 23 15 15 15 15 01 15 15 01 50 51 51 51 51 51 51 51 51 51 51 51 51 51 51 01 15 15 15 01 01 01 01 01 01 01 01 03 03 03 01 15 15 24
23 15 15 15 15 15 24 23 15 15 15 15 01 15 15 01 50 50 50 50 51 51 51 51 51 51 51 51 51 51 51 01 15 15 15 01 15 15 15 01 01 01 01 01 01 01 01 15 15 24
23 15 15 15 15 15 24 23 15 15 15 15 01 15 15 01 01 01 01 01 01 01 01 03 01 01 01 01 01 01 01 01 15 15 15 01 15 15 15 01 01 01 01 01 15 15 15 15 15 24
23 15 15 15 15 15 24 23 15 15 15 15 01 15 15 15 15 15 15 15 15 15 01 03 01 15 15 15 15 15 15 15 15 15 15 01 15 15 01 01 01 01 01 01 15 15 15 15 15 24
23 15 15 15 15 15 24 23 15 15 15 15 01 15 15 15 15 15 15 15 15 15 01 03 01 15 15 15 15 15 15 15 15 01 01 01 15 15 01 01 01 01 01 01 15 15 15 15 15 24
23 15 01 01 15 15 24 23 15 15 15 15 01 01 01 15 15 15 15 15 15 15 01 03 01 15 15 15 15 15 15 15 15 01 15 15 15 01 01 01 01 01 01 01 15 15 15 15 15 24
23 15 01 01 01 15 24 23 15 15 15 15 15 15 01 01 01 01 01 01 15 15 01 03 01 15 15 15 15 15 15 15 15 01 15 15 15 01 01 01 01 01 01 01 15 15 15 15 15 24
23 15 01 25 22 22 83 82 22 15 15 15 15 15 15 15 01 15 15 01 01 01 01 03 01 15 15 15 15 15 15 15 15 01 15 67 60 08 08 08 08 08 08 08 60 66 15 15 15 24
23 15 01 24 20 20 20 20 20 20 20 15 15 15 15 15 01 15 15 15 15 15 01 03 01 15 15 15 15 15 15 01 01 01 15 61 08 72 08 08 08 08 08 08 08 63 15 15 15 24
23 15 01 24 20 20 20 20 20 20 20 20 15 15 15 15 01 15 15 15 15 15 01 03 01 15 15 15 15 15 15 01 15 15 15 61 08 08 08 08 08 08 70 08 08 63 15 15 15 24
23 15 01 24 20 20 20 20 20 20 20 20 20 15 15 15 01 15 15 15 15 15 01 03 01 15 15 15 15 15 15 01 15 15 15 61 08 08 70 08 08 08 08 08 08 63 15 15 15 24
23 15 01 24 20 20 20 20 20 20 20 20 20 23 15 15 01 15 15 15 15 15 01 03 01 15 15 15 15 15 15 01 15 15 15 61 08 08 08 08 08 70 08 08 08 63 15 15 15 24
23 15 01 24 20 81 21 80 20 20 20 20 20 23 15 15 01 15 15 15 15 15 01 03 01 01 01 01 01 01 01 01 15 15 15 61 08 08 08 72 08 08 08 71 08 63 15 15 15 24
23 15 03 03 03 01 01 24 20 20 20 20 20 23 15 15 01 15 15 15 15 15 01 03 01 15 15 15 15 01 15 15 15 15 15 61 08 08 08 08 08 08 08 08 08 63 15 15 15 24
23 15 03 24 20 82 22 83 20 20 20 20 20 23 15 15 01 01 01 15 15 15 01 03 01 15 15 15 15 01 15 15 15 15 15 61 08 08 08 73 08 72 08 08 08 63 15 15 15 24
23 15 03 24 20 20 20 20 20 20 20 20 20 23 15 15 15 15 01 15 15 15 01 03 01 15 15 15 01 01 01 15 15 15 15 61 08 71 08 08 08 08 08 08 08 63 15 15 15 24
23 15 03 24 20 20 20 20 20 20 20 20 20 23 15 15 15 15 01 15 15 15 01 03 01 15 15 01 01 01 01 01 15 15 15 61 08 08 08 08 08 08 08 08 08 63 15 15 15 24
23 15 03 26 21 21 21 21 21 21 21 21 21 27 15 15 15 15 01 15 15 15 01 03 01 15 15 01 01 01 01 01 15 15 15 64 62 62 62 62 62 62 62 62 62 65 15 15 15 24
23 15 03 01 01 01 01 01 01 01 01 01 01 01 01 01 01 01 01 01 01 01 01 03 01 15 15 15 01 01 01 15 15 15 15 15 15 15 15 15 15 15 15 15 15 15 15 15 15 24
23 15 03 03 03 03 03 03 03 03 03 03 03 03 03 03 03 03 03 03 03 03 03 03 01 15 15 15 15 01 15 15 15 15 15 15 15 15 15 15 15 15 15 15 15 15 15 15 15 24
23 15 01 01 01 01 01 01 01 01 01 01 01 01 01 01 01 01 01 01 01 01 01 01 01 15 15 15 15 15 15 15 15 15 15 15 15 15 15 15 15 15 15 15 15 15 15 15 15 24
23 15 15 15 15 15 15 15 15 15 15 15 15 15 15 15 15 15 15 15 15 15 15 15 15 15 15 15 15 15 15 15 15 15 15 15 15 15 15 15 15 15 15 15 15 15 15 15 15 24
82 22 22 22 22 22 22 22 22 22 22 22 22 22 22 22 22 22 22 22 22 22 22 22 22 22 22 22 22 22 22 22 22 22 22 22 22 22 22 22 22 22 22 22 22 22 22 22 22 83