15 15 15 15 15 15 15 15 15 15 15 15 15 15 15 15 15 15 15 15 15 15 15 15 15 15 15 15 15 15 15 15 15 15 15 15 15 15 15 15 15 15 15 15 15 15 15 15 15 24
15 15 15 15 15 15 15 15 15 15 15 15 15 15 15 15 15 15 15 15 15 15 15 15 15 15 15 15 15 15 15 15 15 15 15 15 15 15 15 15 15 15 15 15 15 15 15 15 15 24
15 15 15 15 15 15 15 15 15 15 15 15 15 15 15 15 15 15 15 15 25 22 22 22 22 22 28 15 15 15 15 15 15 15 15 15 15 15 15 15 50 50 50 50 50 50 50 50 50 24
15 15 15 15 15 15 15 15 15 15 15 15 15 15 15 15 15 15 15 15 24 20 20 20 20 20 23 15 15 15 15 15 15 15 15 15 15 15 15 15 50 51 51 51 51 51 51 51 50 24
15 15 15 15 15 15 15 15 15 15 15 15 15 15 15 15 15 15 15 15 24 20 20 20 20 20 23 15 15 15 15 15 15 15 15 15 15 15 15 15 50 51 51 51 51 51 51 51 50 24
15 15 15 15 15 15 15 15 15 15 15 15 15 15 15 15 15 15 15 15 24 20 20 20 20 20 23 15 15 15 15 15 15 15 15 15 15 15 15 15 50 51 51 51 51 51 51 51 50 24
15 15 15 15 15 15 15 15 50 50 50 50 50 15 15 15 15 15 15 15 26 21 21 21 21 21 27 15 15 15 15 15 15 15 15 15 15 15 15 15 50 51 51 51 51 51 51 51 50 24
15 15 15 15 15 15 15 15 50 51 51 51 50 15 15 15 15 15 15 15 01 01 01 03 01 01 01 15 15 15 15 15 15 01 03 03 03 03 03 03 03 03 03 03 03 03 03 03 03 03
15 15 15 15 15 15 15 15 50 51 51 51 50 15 15 15 15 15 15 15 15 01 01 01 01 01 15 15 15 15 15 15 15 15 03 03 03 03 03 03 03 03 15 15 15 15 15 15 15 24
15 15 15 15 15 15 15 15 50 51 51 51 50 15 15 15 15 15 15 15 15 15 01 01 01 15 15 15 15 15 15 15 15 15 03 03 03 03 03 03 03 03 15 15 15 15 15 15 15 24
15 15 15 15 15 15 15 15 50 51 51 51 50 15 15 15 15 15 15 15 15 15 15 03 15 15 15 15 15 15 15 15 15 15 03 03 03 03 03 03 03 03 15 15 15 15 15 15 15 24
15 15 15 15 15 15 15 15 50 50 01 50 50 15 15 15 15 15 15 15 15 15 15 03 15 15 15 15 15 15 15 15 15 15 03 03 03 03 03 03 03 03 15 15 15 15 15 15 15 24
15 15 15 15 15 15 15 15 15 15 01 15 15 15 15 15 15 15 15 15 15 15 15 03 15 15 15 15 15 15 15 15 15 15 15 03 03 03 03 03 03 15 15 15 15 15 15 15 15 24
15 15 15 15 15 15 15 15 15 15 01 15 15 15 15 15 15 15 15 15 15 15 15 03 15 15 15 15 15 15 15 15 15 15 15 15 15 15 03 15 15 15 15 15 15 15 15 15 15 24
15 15 15 15 15 15 15 15 15 15 01 15 15 15 15 15 15 15 15 15 15 15 15 03 15 15 15 15 15 15 15 15 15 15 15 15 15 15 03 15 15 15 15 15 15 15 15 15 15 15
15 15 15 15 15 15 15 15 15 15 01 15 15 15 15 15 15 15 15 15 15 15 15 03 15 15 15 15 15 15 15 15 15 15 15 15 15 15 03 15 15 15 15 15 15 15 15 15 15 15
15 15 15 15 15 15 15 15 01 01 01 15 15 15 15 15 15 15 15 15 15 15 15 03 15 15 15 15 15 15 15 15 15 15 15 15 15 15 03 15 15 15 15 15 15 15 15 15 15 15
15 15 15 15 15 15 15 15 01 15 15 15 15 15 15 15 15 15 15 15 15 15 15 03 15 15 15 15 15 15 15 15 15 15 15 15 15 15 03 15 15 15 15 15 15 15 15 15 15 15
15 15 15 15 15 15 15 15 01 15 15 15 15 15 15 15 15 15 15 15 15 15 01 03 01 15 15 15 15 15 15 15 15 15 15 15 03 03 03 15 15 15 15 15 15 15 15 15 15 15
15 15 15 15 15 15 15 15 01 15 15 15 15 15 15 15 15 15 15 15 15 01 01 03 01 01 15 15 15 15 15 15 15 15 15 15 03 15 15 15 15 15 15 15 15 15 15 15 15 15
15 15 15 15 15 15 15 15 01 15 15 15 15 15 15 15 15 15 15 15 01 01 01 03 01 01 01 15 15 15 15 15 15 15 15 03 03 15 15 15 15 15 15 15 15 15 15 15 15 15
15 15 15 15 15 15 15 15 01 15 15 15 03 03 03 03 03 03 03 03 03 03 03 03 03 03 03 03 03 03 03 03 03 03 03 03 03 15 15 15 15 15 15 15 15 15 15 15 15 15
15 15 15 15 15 15 15 15 01 15 15 15 54 15 15 15 15 15 15 15 01 01 01 03 01 01 01 15 15 15 15 15 15 15 15 15 03 15 15 15 15 15 15 15 15 15 15 15 15 15
15 15 15 15 15 15 15 15 01 15 15 15 01 15 15 15 15 15 15 15 15 01 01 03 01 01 15 15 15 15 15 15 15 15 15 15 03 15 15 15 15 15 15 15 15 15 15 15 15 15
15 15 15 15 15 15 15 15 01 15 15 15 01 15 15 15 15 15 15 15 15 15 01 03 01 15 15 15 15 15 15 15 15 15 15 15 03 15 15 15 15 15 15 15 15 15 15 15 15 15
15 15 15 15 15 15 15 15 01 15 15 15 01 01 01 15 15 15 15 15 15 15 15 03 15 15 15 15 15 15 15 15 15 15 15 15 03 15 15 15 15 15 15 15 15 15 15 15 15 15
15 15 15 15 15 15 15 15 01 15 15 15 15 15 01 15 15 15 15 15 15 15 15 03 15 15 15 15 15 15 15 15 15 15 15 15 03 15 15 15 15 15 15 15 15 15 15 15 15 15
15 15 15 15 15 15 15 15 01 15 15 15 15 15 01 15 15 15 15 15 15 15 15 03 15 15 15 01 15 15 15 15 15 15 15 01 03 15 15 15 15 15 15 15 15 15 15 15 15 15
15 15 15 15 15 15 15 15 01 15 15 15 15 15 01 15 15 15 15 15 15 15 15 03 15 15 15 15 15 15 01 15 15 15 15 15 03 15 15 15 15 15 15 15 15 15 15 15 15 15
15 15 15 15 15 15 15 15 01 01 01 01 01 01 01 15 15 15 15 15 15 15 15 03 15 15 15 15 15 15 01 15 15 15 15 15 03 15 15 15 15 15 15 15 15 15 15 15 15 15
15 15 15 15 15 15 15 15 01 01 01 01 01 01 01 15 15 15 15 15 15 15 15 03 15 15 15 15 15 15 15 15 15 15 15 15 01 15 15 15 15 15 15 15 15 15 15 15 15 15
15 15 15 15 15 15 15 15 01 01 01 01 01 01 01 15 15 15 15 15 15 15 15 03 15 15 15 15 15 15 15 15 15 15 15 01 01 01 15 15 15 15 15 15 15 15 15 15 15 15
15 15 15 15 15 15 15 15 01 01 01 01 01 01 01 15 15 15 15 15 15 15 15 03 15 15 15 15 15 15 15 15 15 15 15 01 01 01 15 15 15 15 15 15 15 15 15 15 15 15
15 15 15 15 15 15 15 15 01 01 01 01 01 01 01 15 15 15 15 15 15 15 15 03 15 15 15 15 15 15 15 15 15 15 15 01 01 01 15 15 15 15 15 15 15 15 15 15 15 15
15 15 15 15 15 15 15 15 01 01 01 01 01 01 01 15 15 15 15 15 15 15 15 03 15 15 15 15 15 15 15 15 15 15 15 01 01 01 15 15 15 15 15 15 15 15 15 15 15 15
15 15 15 15 15 15 15 15 15 15 15 15 15 15 15 15 15 15 15 15 15 15 15 03 15 15 15 15 15 15 15 15 15 15 15 01 01 01 15 15 15 15 15 15 15 15 15 15 15 15
15 15 15 15 15 15 15 15 15 15 15 15 15 15 15 15 15 15 15 01 01 01 01 03 01 01 01 15 15 15 15 15 15 15 01 01 01 01 01 15 15 15 15 15 15 15 15 15 15 15
15 15 15 15 15 15 15 15 15 15 15 15 15 15 15 15 15 15 01 01 01 01 01 03 01 01 01 01 15 15 01 15 15 01 01 01 01 01 01 15 15 15 15 15 15 15 15 15 15 15
15 15 15 15 15 15 15 15 15 15 15 15 15 15 15 15 15 15 01 01 01 01 01 03 01 01 01 01 15 15 15 15 01 01 01 01 01 01 01 15 15 15 15 15 15 15 15 15 15 15
15 15 15 15 15 15 15 15 15 15 15 15 15 01 15 15 15 15 01 01 01 01 01 03 01 01 01 01 01 15 15 15 01 01 01 01 01 15 01 15 15 15 15 15 15 15 15 15 15 15
15 15 15 15 15 15 15 15 15 15 15 15 15 15 15 15 15 15 01 01 01 01 01 03 01 01 01 01 01 01 01 01 01 01 15 01 01 01 01 15 15 15 15 15 15 15 15 15 15 15
15 15 15 15 15 15 15 15 15 15 15 15 15 01 15 15 15 15 15 01 01 01 01 03 01 01 01 15 15 15 15 01 01 01 01 01 01 01 01 15 15 15 15 15 15 15 15 15 15 15
15 15 15 15 15 15 15 15 15 15 15 15 15 15 15 15 15 15 15 15 01 01 01 03 01 01 15 15 15 15 15 01 01 15 01 01 15 01 01 15 15 15 15 15 15 15 15 15 15 15
15 15 15 15 15 15 15 15 15 15 15 15 15 15 15 15 15 15 15 15 15 15 15 03 15 15 15 15 15 15 15 15 01 01 01 01 01 01 15 15 15 15 15 15 15 15 15 15 15 15
15 15 15 15 15 15 15 15 15 15 15 15 15 15 15 15 15 15 15 15 15 15 15 03 15 15 15 15 15 15 15 15 15 15 15 15 15 15 15 15 15 15 15 15 15 15 15 15 15 15
15 15 15 15 15 15 15 15 15 15 15 15 15 15 15 15 15 15 15 15 15 15 15 03 15 15 15 15 15 15 15 15 15 15 15 15 15 15 15 15 15 15 15 15 15 15 15 15 15 15
15 15 15 15 15 15 15 15 15 15 15 15 15 15 15 15 15 15 15 15 15 15 15 03 15 15 15 15 15 15 15 15 15 15 15 15 15 15 15 15 15 15 15 15 15 15 15 15 15 15
15 15 15 15 15 15 15 15 15 15 15 15 15 15 15 15 15 15 15 15 15 15 15 03 15 15 15 15 15 15 15 15 15 15 15 15 15 15 15 15 15 15 15 15 15 15 15 15 15 15
15 15 15 15 15 15 15 15 15 15 15 15 15 15 15 15 15 15 15 15 15 15 15 03 15 15 15 15 15 15 15 15 15 15 15 15 15 15 15 15 15 15 15 15 15 15 15 15 15 15
15 15 15 15 15 15 15 15 15 15 15 15 15 15 15 15 15 15 15 15 15 15 15 03 15 15 15 15 15 15 15 15 15 15 15 15 15 15 15 15 15 15 15 15 15 15 15 15 15 15
17 07 07 07 07 07 07 07 07 07 07 07 07 07 07 07 07 07 07 07 07 07 07 04 07 07 07 07 07 07 07 07 07 07 07 07 07 07 07 07 07 07 07 07 07 07 07 07 07 17
17 07 07 07 07 07 07 07 07 11 07 07 07 07 07 07 07 07 07 07 07 07 07 04 07 07 07 07 07 11 07 07 07 07 07 07 07 07 07 07 07 07 07 07 07 07 07 07 07 17
17 07 07 07 07 07 07 07 07 07 07 07 07 07 07 07 07 07 07 07 07 07 07 04 07 07 07 07 07 07 07 07 07 07 07 07 07 07 07 07 07 07 07 07 07 07 07 07 07 17
17 07 07 07 07 07 07 07 07 07 07 07 07 07 07 07 07 07 07 07 07 07 07 04 07 07 07 07 07 07 07 07 07 07 07 07 07 07 07 07 07 07 11 07 07 07 07 07 07 17
17 07 07 07 07 07 07 07 07 07 07 07 07 07 07 07 07 11 07 07 07 07 07 04 07 07 07 07 07 07 07 07 07 07 07 07 11 07 07 07 07 07 07 07 07 07 07 07 07 17
17 07 07 07 07 07 07 07 07 07 11 07 07 07 07 07 07 07 07 07 07 07 07 04 04 04 04 04 04 04 04 04 04 04 04 04 04 04 04 04 04 04 04 04 04 04 07 07 07 17
17 07 07 07 07 07 07 07 07 07 07 07 07 07 07 07 07 07 07 07 07 07 07 07 07 07 11 07 07 07 07 07 07 07 07 07 07 07 07 07 07 07 07 07 07 04 07 07 07 17
17 07 07 07 07 07 07 07 07 07 07 07 07 07 07 07 07 07 07 07 07 07 07 07 07 07 07 07 07 07 07 07 07 07 07 07 07 07 07 07 07 11 07 07 07 04 07 07 07 17
17 17 17 17 17 17 17 17 17 17 17 17 17 17 17 17 17 17 17 17 17 17 17 17 17 17 17 17 17 17 17 17 17 17 17 17 17 17 17 17 17 17 17 17 17 04 17 17 17 17
18 06 06 06 06 06 06 06 06 06 06 06 06 06 06 06 06 06 06 06 06 06 06 06 06 06 06 06 06 06 06 06 06 06 06 06 06 06 06 06 06 06 06 06 06 05 06 06 06 18
18 06 06 06 06 06 06 06 06 06 06 06 06 06 06 06 06 06 06 06 06 06 06 06 06 06 06 06 06 06 06 06 06 06 06 06 06 06 06 06 06 06 06 06 06 05 06 06 06 18
18 06 06 06 06 06 06 06 06 06 06 06 06 06 06 06 06 06 06 06 06 06 06 06 06 06 06 06 06 06 06 06 06 06 06 06 06 06 06 06 06 06 06 06 06 05 06 06 06 18
18 06 06 06 06 06 06 06 06 06 06 06 06 06 06 06 06 06 06 06 06 06 06 35 31 31 31 31 31 38 06 06 06 06 06 06 06 06 06 06 06 06 06 06 06 05 06 06 06 18
18 06 06 06 06 06 67 60 60 60 60 60 60 60 60 66 06 06 06 06 06 06 06 33 40 40 40 40 40 34 06 06 06 06 06 06 06 06 06 06 06 06 06 06 06 05 06 06 06 18
18 06 06 06 06 06 61 08 08 70 08 08 72 08 08 63 06 06 06 06 06 06 06 36 32 32 32 32 32 37 06 06 06 06 06 06 06 06 06 06 06 06 06 06 06 05 06 06 06 18
18 06 06 06 06 06 61 08 08 08 08 71 08 08 08 63 06 06 06 06 06 06 06 06 06 06 06 06 06 06 06 06 06 06 06 06 06 06 06 06 06 06 06 06 06 05 06 06 06 18
18 06 06 06 06 06 61 08 08 08 08 08 08 08 73 63 06 06 06 06 06 06 06 06 06 06 06 06 06 06 06 06 06 06 06 06 06 06 06 06 06 06 06 06 06 05 06 06 06 18
18 06 06 06 06 06 64 62 62 62 62 62 62 62 62 65 05 05 05 05 05 05 05 05 05 05 05 05 05 05 05 05 05 05 05 05 05 05 05 05 05 05 05 05 05 05 06 06 06 18
18 06 06 06 06 06 06 06 06 06 06 06 06 06 06 06 06 06 06 06 06 06 06 06 06 06 06 06 06 06 06 06 06 06 06 06 06 06 06 06 06 06 06 06 06 06 06 06 06 18
18 18 18 18 18 18 18 18 18 18 18 18 18 18 18 18 18 18 18 18 18 18 18 18 18 18 18 18 18 18 18 18 18 18 18 18 18 18 18 18 18 18 18 18 18 18 18 18 18 18



